------------------------
------------------------
---------@@@@@@---------
--------------$---------
------@@@@@--@@@@@------
----------$-------------
---@@@@--@@@@@--@@@@@---
-----------------$------
-@@@@--@@@@@---@@@@@@---
--------$---------------
----@@@@@@---@@@@@@-----
---$--------------------
--@@@@@@--@@@@@@--@@@@@-
---------------------$--
------------------------
@@@@@@@@@@@@@@@@@@@@@@@@
