------------------------
------------------------
------------------------
------------------------
----$--$-|--|-$$-|$-----
-----@@@@|--@@@@-|------
--$--$--|--$--$--|--$---
@@@@@@@@@|@@@@@@@|@@@@@@
---------|-------|------
---------|-------|------
---------|-------|------
---------|-------|------
---------|-------|------
---------|-------|------
-$--$--$-|-$$--$-|-$--$-
@@@@@@@@@@@@@@@@@@@@@@@@
