------------------------
------------------------
------------------------
------------------------
------$--------$--------
-----@@@@---@@@@--------
---------|-------|------
@@@@@@@@@|@@@@@@@|@@@@@@
---------|-------|------
---------|-------|------
---$-----|--$----|--$---
---------|-------|------
---------|-------|------
---------|-------|------
-----$---|---$---|--$---
@@@@@@@@@@@@@@@@@@@@@@@@
