------------------------
------------------------
------------------------
------------------------
------------------------
------------------------
------------------------
------------------------
------------------------
------------------------
----$-------------------
------------------------
-------------------$----
@@@@@@@@@@@@@@@@@@@@@@@@
------------------------
@@@@@@@@@@@@@@@@@@@@@@@@

