------------------------
------------------------
------------------------
------------------------
---$--$-|-$$-$|-$-------
--@@@@@-|-@@@@|-@@@@@@--
-$--$$--|-$--$|---$$--$-
@@@@@@@@|@@@@@|@@@@@@@@@
--------|-----|---------
--------|-----|---------
--------|-----|---------
--------|-----|---------
--------|-----|---------
--------|-----|---------
-$--$-$-|-$$-$|--$--$$--
@@@@@@@@@@@@@@@@@@@@@@@@
